__________
____R_____
____R_____
_ORRO_____
_RORRRRRO_
_RR_R___R_
_ORRORORR_
__ORR_R_R_
____ORRRO_
______R___
_____XO___