___R____
___R____
ORRO____
RORRRRRO
RR_R___R
ORRORORR
_ORR_R_R
___ORRRO
_____R__
____RO__